################################################################################
#                                                                              #
#  ~~~~                                                   #####               #
#  ~~~~                                                   #   #               #
#                                                         #   #               #
#                    ####                                 #####               #
#                    #  #                                                      #
#                    #  #                                                      #
#                    ####                                                      #
#                                                                              #
#          o                                                                   #
#                                                                              #
#                              ########                                        #
#                              #      #                                        #
#                              #      #                                        #
#                              ########                                        #
#                                                                              #
#                  o                                                           #
#                                                                              #
#                                                         ~~~~                #
#                                                         ~~~~                #
################################################################################
